
###########################
#J#####MMMMMMMMM##B########
#MM######MMMO####MMM#######
##MMMC####MMMMM##MMMMMMM###
##MMMM#######M#MMMMMMOMMMM#
#####M#######A#MMMMMMMM####
#MMMMMMMMMMMDC#MMMMMM######
#A###############MMMM######
#C#####MMMMMMMMMMMMMOMDCMM#
#BOMMMMMMMMMMMM########MMM#
###########################