
###########################
#CMOMMMBM#########MMMMOMMC#
#M#D##M#MMM###MMBMM####M#M#
#MMM##MMM###M####M#MMMMMDM#
###MMMMMM###MMMMMM#M###C###
#OMM####MMMMD####MMM##MMMO#
#M#MMDMM###MMMMM###M##M##M#
#M###M#MMMMM#M#MMMMM##M##M#
#M###M#####M#M#M###M##M##M#
#CMMMMM####MMJMM###MMMMMMC#
###########################